AAA	Lys
AAC	Asn
AAG	Lys
AAU	Asn
ACA	Thr
ACC	Thr
ACG	Thr
ACU	Thr
AGA	Arg
AGC	Ser
AGG	Arg
AGU	Ser
AUA	Ile
AUC	Ile
AUG	Met
AUU	Ile
CAA	Gln
CAC	His
CAG	Gln
CAU	His
CCA	Pro
CCC	Pro
CCG	Pro
CCU	Pro
CGA	Arg
CGC	Arg
CGG	Arg
CGU	Arg
CUA	Leu
CUC	Leu
CUG	Leu
CUU	Leu
GAA	Glu
GAC	Asp
GAG	Glu
GAU	Asp
GCA	Ala
GCC	Ala
GCG	Ala
GCU	Ala
GGA	Gly
GGC	Gly
GGG	Gly
GGU	Gly
GUA	Val
GUC	Val
GUG	Val
GUU	Val
UAU	Tyr
UAC	Tyr
UAA	STOP
UAG	STOP
UCA	Ser
UCC	Ser
UCG	Ser
UCU	Ser
UGA	STOP
UGG	Trp
UGU	Cys
UGC	Cys
UUA	Leu
UUC	Phe
UUG	Leu
UUU	Phe
